
 ┌─────────────────┐
 │ level1          │
 │                 │
 │                 │
 │ ┌─────────────┐ │
 │ │ level2      │ │
 │ │             │ │
 │ │             │ │
 │ │ ┌─────────┐ │ │
 │ │ │ level3  │ │ │
 │ │ │         │ │ │
 │ │ │         │ │ │
 │ │ │ ┌─────┐ │ │ │
 │ │ │ │     │ │ │ │
 │ │ │ │  A  │ │ │ │
 │ │ │ │     │ │ │ │
 │ │ │ └─────┘ │ │ │
 │ │ │         │ │ │
 │ │ └─────────┘ │ │
 │ │             │ │
 │ └─────────────┘ │
 │                 │
 └─────────────────┘
